user_id,AIQ_total_spend,Johnny_total_spend,Difference in total_spend,,,,
5988,3500,4208,708,,,,
5983,3061,4537,1476,,,,
6796,1062,4417,3355,,,,
6792,3583,4271,688,,,,
6790,1912,4770,2858,,,,
6791,3553,4230,677,,,,"From the data in excel,"
6798,3160,4537,1377,,,,Sum of Johnny_total_spend  = 8290846 
272,1459,4835,3376,,,,       Sum of AIQ_total_spend = 3548365 
276,1054,4179,3125,,,,                                 Difference = 4742481
279,1604,4210,2606,,,,
9252,239,4365,4126,,,,"Total revenue - Johnny Summary  = $33,904,525"
3519,3562,4751,1189,,,,"      Total revenue - AIQ Summary  = $29,162,044"
3511,1557,4654,3097,,,,"                                  Difference  = $ 4,742,481"
3516,2217,4025,1808,,,,
3514,2078,4857,2779,,,,
2688,842,4889,4047,,,,
2687,453,4840,4387,,,,
92,562,4897,4335,,,,
1174,2153,4393,2240,,,,
7183,3862,4505,643,,,,
7187,2530,4948,2418,,,,
1225,1549,4935,3386,,,,
8549,486,4455,3969,,,,
8548,427,4901,4474,,,,
7457,2420,4187,1767,,,,
7451,2432,4166,1734,,,,
7459,591,4465,3874,,,,
2745,3760,4325,565,,,,
2744,1520,4923,3403,,,,
2031,2273,4105,1832,,,,
6535,884,4605,3721,,,,
6532,1472,4041,2569,,,,
2038,2142,4264,2122,,,,
2300,2756,4349,1593,,,,
5846,3649,4700,1051,,,,
5843,1405,4351,2946,,,,
5849,1140,4044,2904,,,,
3744,3350,4934,1584,,,,
3742,3672,4460,788,,,,
4620,2416,4572,2156,,,,
4629,393,4455,4062,,,,
171,2050,4942,2892,,,,
7213,2771,4987,2216,,,,
7215,916,4025,3109,,,,
6217,3250,4391,1141,,,,
6216,2098,4693,2595,,,,
6211,701,4870,4169,,,,
6210,3369,4706,1337,,,,
6218,3931,4981,1050,,,,
6818,3235,4840,1605,,,,
6811,3134,4876,1742,,,,
6813,1879,4557,2678,,,,
6816,3129,4887,1758,,,,
9754,3019,4306,1287,,,,
9752,2751,4733,1982,,,,
9751,2315,4519,2204,,,,
9759,662,4809,4147,,,,
8846,1976,4617,2641,,,,
7660,679,4044,3365,,,,
1546,3293,4524,1231,,,,
1547,829,4035,3206,,,,
690,250,4180,3930,,,,
695,1178,4739,3561,,,,
698,870,4823,3953,,,,
1548,1365,4086,2721,,,,
5617,970,4485,3515,,,,
7118,2732,4459,1727,,,,
9250,3890,4103,213,,,,
6777,2967,4041,1074,,,,
6771,2991,4826,1835,,,,
9965,723,4404,3681,,,,
9960,1030,4966,3936,,,,
9961,2183,4315,2132,,,,
259,20,4651,4631,,,,
254,454,4520,4066,,,,
9509,1439,4140,2701,,,,
9504,1869,4428,2559,,,,
9505,2413,4583,2170,,,,
3683,702,4235,3533,,,,
2511,520,4701,4181,,,,
2513,1230,4950,3720,,,,
5054,3079,4391,1312,,,,
1157,3879,4134,255,,,,
8525,3469,4884,1415,,,,
4295,929,4098,3169,,,,
4297,3446,4764,1318,,,,
4749,2262,4610,2348,,,,
4747,2619,4887,2268,,,,
5867,3132,4803,1671,,,,
2187,1510,4967,3457,,,,
4605,3936,4626,690,,,,
6452,1509,4881,3372,,,,
6902,2820,4761,1941,,,,
159,1748,4055,2307,,,,
6185,2885,4904,2019,,,,
6909,1709,4580,2871,,,,
8133,2385,4434,2049,,,,
2725,2291,4531,2240,,,,
2723,1653,4323,2670,,,,
2722,609,4697,4088,,,,
2729,1757,4799,3042,,,,
7236,2967,4115,1148,,,,
7233,436,4051,3615,,,,
9198,1621,4928,3307,,,,
7238,2355,4649,2294,,,,
6235,3827,4015,188,,,,
6237,2305,4913,2608,,,,
6236,3061,4718,1657,,,,
9778,3036,4125,1089,,,,
8863,22,4344,4322,,,,
8868,286,4568,4282,,,,
819,1814,4408,2594,,,,
812,3307,4863,1556,,,,
817,1473,4266,2793,,,,
7934,1041,4456,3415,,,,
7936,1595,4728,3133,,,,
3027,1984,4099,2115,,,,
3023,3238,4164,926,,,,
8735,1859,4638,2779,,,,
8733,975,4938,3963,,,,
8731,330,4675,4345,,,,
4198,2286,4195,1909,,,,
4196,3372,4329,957,,,,
8195,2662,4078,1416,,,,
8199,1053,4663,3610,,,,
6755,1995,4981,2986,,,,
9941,1352,4088,2736,,,,
9949,480,4618,4138,,,,
239,1136,4684,3548,,,,
235,3372,4743,1371,,,,
2532,2670,4154,1484,,,,
2537,3779,4873,1094,,,,
5073,539,4359,3820,,,,
5074,1464,4699,3235,,,,
933,1042,4771,3729,,,,
931,3017,4568,1551,,,,
9382,2657,4165,1508,,,,
798,3937,4664,727,,,,
2417,2178,4226,2048,,,,
7148,439,4987,4548,,,,
7149,2111,4493,2382,,,,
7144,659,4575,3916,,,,
8503,1304,4747,3443,,,,
8504,3585,4409,824,,,,
2882,2583,4664,2081,,,,
2880,3422,4738,1316,,,,
2885,1434,4780,3346,,,,
4763,3984,4481,497,,,,
4765,149,4851,4702,,,,
4766,3886,4951,1065,,,,
4769,3041,4800,1759,,,,
4768,1343,4994,3651,,,,
5801,608,4772,4164,,,,
5806,1435,4457,3022,,,,
685,377,4564,4187,,,,
1577,3930,4953,1023,,,,
4888,3106,4944,1838,,,,
4889,3115,4061,946,,,,
2709,2739,4702,1963,,,,
4882,530,4910,4380,,,,
7963,58,4009,3951,,,,
7966,1867,4201,2334,,,,
9175,2806,4628,1822,,,,
9173,3792,4887,1095,,,,
6250,1219,4013,2794,,,,
6256,3594,4375,781,,,,
8547,341,4069,3728,,,,
3471,3471,4135,664,,,,
8882,591,4665,4074,,,,
7023,271,4478,4207,,,,
5241,2639,4158,1519,,,,
7027,1096,4421,3325,,,,
7283,476,4571,4095,,,,
3001,2058,4071,2013,,,,
7286,934,4961,4027,,,,
1588,661,4628,3967,,,,
1589,3734,4109,375,,,,
7937,1301,4037,2736,,,,
1580,2378,4279,1901,,,,
1587,1558,4662,3104,,,,
1584,987,4823,3836,,,,
9452,599,4072,3473,,,,
5658,3925,4674,749,,,,
6419,992,4533,3541,,,,
6412,2917,4971,2054,,,,
7771,691,4156,3465,,,,
3912,1142,4539,3397,,,,
3911,2108,4957,2849,,,,
3918,3391,4639,1248,,,,
6730,2662,4859,2197,,,,
8318,2785,4933,2148,,,,
9927,3631,4949,1318,,,,
215,1705,4879,3174,,,,
213,720,4890,4170,,,,
210,3583,4680,1097,,,,
219,3289,4200,911,,,,
3646,16,4258,4242,,,,
3640,943,4255,3312,,,,
2550,140,4042,3902,,,,
2552,494,4963,4469,,,,
5012,687,4087,3400,,,,
4419,1181,4341,3160,,,,
4414,641,4926,4285,,,,
4413,1380,4061,2681,,,,
4412,415,4333,3918,,,,
918,549,4586,4037,,,,
9548,3546,4687,1141,,,,
9541,3215,4896,1681,,,,
7162,3149,4318,1169,,,,
7167,3109,4077,968,,,,
7164,1286,4822,3536,,,,
7165,135,4663,4528,,,,
8079,1821,4074,2253,,,,
8075,3651,4725,1074,,,,
8076,1828,4368,2540,,,,
1216,267,4338,4071,,,,
1111,738,4068,3330,,,,
2005,2184,4264,2080,,,,
2301,1233,4662,3429,,,,
4850,3995,4975,980,,,,
4789,1338,4063,2725,,,,
4784,1869,4107,2238,,,,
5821,2673,4762,2089,,,,
5822,1062,4256,3194,,,,
5825,1021,4429,3408,,,,
197,801,4402,3601,,,,
196,1014,4246,3232,,,,
191,1396,4223,2827,,,,
190,2982,4576,1594,,,,
192,3776,4027,251,,,,
9151,93,4523,4430,,,,
9150,637,4390,3753,,,,
2761,1401,4196,2795,,,,
9159,1582,4514,2932,,,,
7909,2277,4673,2396,,,,
9489,2788,4088,1300,,,,
7901,3757,4773,1016,,,,
9481,3372,4650,1278,,,,
9487,866,4722,3856,,,,
9485,3295,4371,1076,,,,
9484,3581,4733,1152,,,,
6271,1567,4900,3333,,,,
6273,1722,4691,2969,,,,
6272,3657,4978,1321,,,,
6274,1726,4829,3103,,,,
9734,622,4156,3534,,,,
859,419,4857,4438,,,,
5227,215,4131,3916,,,,
3063,1474,4887,3413,,,,
3066,1331,4062,2731,,,,
3068,478,4782,4304,,,,
1305,391,4953,4562,,,,
495,3940,4029,89,,,,
496,1946,4979,3033,,,,
492,1338,4318,2980,,,,
6471,2526,4588,2062,,,,
6470,3789,4635,846,,,,
7757,3470,4676,1206,,,,
7752,3985,4001,16,,,,
9534,46,4558,4512,,,,
3937,3455,4566,1111,,,,
8331,634,4278,3644,,,,
8336,2146,4027,1881,,,,
9900,1102,4106,3004,,,,
9909,3165,4886,1721,,,,
4045,3457,4088,631,,,,
4040,2274,4961,2687,,,,
4041,1992,4110,2118,,,,
3660,448,4564,4116,,,,
3663,3046,4379,1333,,,,
3669,2818,4623,1805,,,,
2578,316,4671,4355,,,,
2576,2772,4524,1752,,,,
2577,3863,4375,512,,,,
2571,3601,4267,666,,,,
3593,566,4066,3500,,,,
3590,3292,4153,861,,,,
3595,921,4689,3768,,,,
5034,1340,4835,3495,,,,
5030,483,4671,4188,,,,
4431,55,4701,4646,,,,
4438,1786,4154,2368,,,,
972,2185,4123,1938,,,,
3386,3320,4794,1474,,,,
7106,1590,4910,3320,,,,
1685,3380,4615,1235,,,,
1467,381,4862,4481,,,,
1466,1265,4806,3541,,,,
4238,42,4937,4895,,,,
4236,83,4670,4587,,,,
4235,3188,4466,1278,,,,
4231,1152,4971,3819,,,,
312,148,4141,3993,,,,
7284,1799,4164,2365,,,,
7289,105,4610,4505,,,,
2293,1926,4020,2094,,,,
2294,2947,4661,1714,,,,
7922,1684,4712,3028,,,,
9136,3614,4765,1151,,,,
7298,1873,4094,2221,,,,
7929,106,4566,4460,,,,
6298,3963,4661,698,,,,
6295,33,4051,4018,,,,
6290,1240,4611,3371,,,,
3438,3058,4793,1735,,,,
3430,1634,4460,2826,,,,
874,42,4410,4368,,,,
871,3572,4235,663,,,,
2741,2825,4727,1902,,,,
4848,3535,4334,799,,,,
4594,1442,4518,3076,,,,
4845,454,4357,3903,,,,
4846,2677,4297,1620,,,,
4847,2050,4799,2749,,,,
2039,1561,4030,2469,,,,
5202,3972,4839,867,,,,
5193,3409,4057,648,,,,
1911,3078,4006,928,,,,
3040,1812,4164,2352,,,,
3045,2434,4057,1623,,,,
1320,768,4342,3574,,,,
1325,1050,4009,2959,,,,
8139,3905,4733,828,,,,
7733,1003,4284,3281,,,,
3956,2330,4586,2256,,,,
8350,3069,4484,1415,,,,
8353,2887,4162,1275,,,,
8354,16,4764,4748,,,,
8355,568,4218,3650,,,,
4068,2636,4007,1371,,,,
3600,1215,4942,3727,,,,
3609,339,4394,4055,,,,
4455,129,4734,4605,,,,
959,2265,4690,2425,,,,
6337,115,4250,4135,,,,
9677,2544,4738,2194,,,,
4966,979,4444,3465,,,,
7122,364,4300,3936,,,,
1669,1665,4181,2516,,,,
1668,1187,4528,3341,,,,
1664,607,4185,3578,,,,
1663,3390,4770,1380,,,,
1661,2498,4088,1590,,,,
1660,1286,4366,3080,,,,
597,586,4570,3984,,,,
2821,3354,4661,1307,,,,
5416,3136,4263,1127,,,,
5417,3472,4411,939,,,,
3383,3231,4509,1278,,,,
3380,672,4843,4171,,,,
1409,3355,4220,865,,,,
4215,3692,4322,630,,,,
5577,708,4602,3894,,,,
6109,2076,4928,2852,,,,
6106,2860,4129,1269,,,,
6104,321,4449,4128,,,,
6102,1463,4552,3089,,,,
6100,122,4570,4448,,,,
9445,225,4008,3783,,,,
3413,1123,4214,3091,,,,
2019,0,4116,4116,,,,
2017,3889,4075,186,,,,
2010,1682,4831,3149,,,,
458,3074,4134,1060,,,,
1343,1426,4290,2864,,,,
1345,76,4578,4502,,,,
1346,3565,4883,1318,,,,
8119,1662,4852,3190,,,,
6928,2007,4112,2105,,,,
8113,3053,4364,1311,,,,
8111,2969,4723,1754,,,,
6923,3550,4296,746,,,,
7711,2278,4787,2509,,,,
7719,2281,4851,2570,,,,
8371,566,4571,4005,,,,
9572,1317,4234,2917,,,,
8141,139,4442,4303,,,,
4001,1530,4582,3052,,,,
4004,2145,4841,2696,,,,
3977,1751,4469,2718,,,,
3979,3179,4028,849,,,,
3623,1155,4602,3447,,,,
3625,1446,4341,2895,,,,
4477,2401,4166,1765,,,,
2463,1879,4303,2424,,,,
6313,3191,4263,1072,,,,
6310,3835,4497,662,,,,
6318,2669,4620,1951,,,,
9657,453,4342,3889,,,,
9304,1660,4660,3000,,,,
9658,3679,4951,1272,,,,
1648,2218,4760,2542,,,,
570,3547,4558,1011,,,,
2802,743,4448,3705,,,,
5430,2756,4190,1434,,,,
1426,3047,4895,1848,,,,
5438,3489,4849,1360,,,,
3360,3,4064,4061,,,,
4272,3758,4617,859,,,,
5556,3716,4785,1069,,,,
5550,2696,4541,1845,,,,
5559,644,4344,3700,,,,
5558,3097,4866,1769,,,,
2016,2594,4638,2044,,,,
4867,59,4645,4586,,,,
5883,3270,4855,1585,,,,
5880,3463,4279,816,,,,
5887,2370,4477,2107,,,,
5889,2632,4338,1706,,,,
5888,3149,4718,1569,,,,
6558,612,4409,3797,,,,
356,568,4052,3484,,,,
9884,2710,4169,1459,,,,
7503,2778,4633,1855,,,,
7508,3518,4881,1363,,,,
359,37,4184,4147,,,,
4855,860,4523,3663,,,,
6123,253,4990,4737,,,,
6122,637,4780,4143,,,,
6129,529,4527,3998,,,,
2254,2613,4007,1394,,,,
4801,931,4329,3398,,,,
4638,3509,4432,923,,,,
4806,3363,4198,835,,,,
4808,220,4751,4531,,,,
9464,3901,4421,520,,,,
9468,1724,4257,2533,,,,
9795,1675,4657,2982,,,,
9798,2170,4373,2203,,,,
7082,50,4747,4697,,,,
7088,125,4499,4374,,,,
6495,3548,4864,1316,,,,
8174,1693,4186,2493,,,,
8178,3305,4458,1153,,,,
6949,1736,4071,2335,,,,
6948,924,4829,3905,,,,
6946,3875,4509,634,,,,
4399,1157,4437,3280,,,,
4391,3074,4963,1889,,,,
4394,1774,4418,2644,,,,
3195,3253,4940,1687,,,,
3194,3724,4367,643,,,,
477,3780,4039,259,,,,
474,1416,4765,3349,,,,
1369,261,4306,4045,,,,
4025,147,4287,4140,,,,
3998,659,4280,3621,,,,
3995,460,4359,3899,,,,
8697,3048,4680,1632,,,,
299,3653,4603,950,,,,
295,859,4196,3337,,,,
2440,1277,4990,3713,,,,
2448,2144,4040,1896,,,,
7865,514,4046,3532,,,,
7868,392,4826,4434,,,,
6375,1711,4530,2819,,,,
9638,3635,4192,557,,,,
9323,1669,4232,2563,,,,
9632,121,4664,4543,,,,
8943,1054,4434,3380,,,,
8946,1376,4960,3584,,,,
1437,652,4164,3512,,,,
1992,890,4673,3783,,,,
1629,3530,4066,536,,,,
2868,911,4112,3201,,,,
2869,615,4817,4202,,,,
553,2800,4562,1762,,,,
552,1734,4383,2649,,,,
3348,419,4498,4079,,,,
3342,1685,4080,2395,,,,
3341,3775,4226,451,,,,
1197,2996,4426,1430,,,,
4257,3174,4626,1452,,,,
1349,2592,4967,2375,,,,
6576,1011,4185,3174,,,,
6577,3560,4576,1016,,,,
7691,479,4524,4045,,,,
7693,3897,4586,689,,,,
7698,3024,4205,1181,,,,
1342,2040,4596,2556,,,,
3836,2442,4634,2192,,,,
3207,432,4062,3630,,,,
7526,3059,4674,1615,,,,
7527,1400,4701,3301,,,,
370,886,4402,3516,,,,
7529,2711,4057,1346,,,,
377,160,4593,4433,,,,
6141,2414,4935,2521,,,,
6144,3611,4100,489,,,,
6921,3268,4432,1164,,,,
8115,1426,4591,3165,,,,
2275,1567,4411,2844,,,,
2273,296,4197,3901,,,,
2056,2139,4206,2067,,,,
4536,3887,4360,473,,,,
7320,400,4971,4571,,,,
7321,1075,4373,3298,,,,
7322,932,4061,3129,,,,
802,1413,4537,3124,,,,
7066,1757,4867,3110,,,,
7065,3228,4758,1530,,,,
6961,1949,4713,2764,,,,
8628,2668,4007,1339,,,,
8153,2863,4747,1884,,,,
416,66,4330,4264,,,,
1389,266,4513,4247,,,,
412,1885,4693,2808,,,,
413,445,4762,4317,,,,
7224,197,4246,4049,,,,
5277,1131,4061,2930,,,,
1771,1183,4201,3018,,,,
1770,1357,4683,3326,,,,
5278,1068,4746,3678,,,,
6680,1467,4907,3440,,,,
6681,1969,4276,2307,,,,
6683,3418,4171,753,,,,
6685,2470,4723,2253,,,,
2420,1103,4788,3685,,,,
2421,1415,4955,3540,,,,
2422,1736,4839,3103,,,,
2424,1415,4005,2590,,,,
2425,3490,4940,1450,,,,
7849,531,4991,4460,,,,
7844,1284,4081,2797,,,,
6354,2973,4082,1109,,,,
6352,3995,4964,969,,,,
6350,1499,4172,2673,,,,
9340,1126,4679,3553,,,,
9345,3587,4704,1117,,,,
9346,2682,4433,1751,,,,
9618,3517,4772,1255,,,,
1609,1592,4345,2753,,,,
1978,362,4905,4543,,,,
2846,3380,4378,998,,,,
5476,3795,4172,377,,,,
5478,3863,4201,338,,,,
5519,2367,4367,2000,,,,
5511,2761,4886,2125,,,,
5510,493,4333,3840,,,,
536,5,4007,4002,,,,
535,1531,4065,2534,,,,
531,418,4412,3994,,,,
539,1834,4115,2281,,,,
6513,1700,4213,2513,,,,
3293,1693,4773,3080,,,,
3817,2569,4020,1451,,,,
8458,1711,4481,2770,,,,
7548,1929,4314,2385,,,,
7544,356,4396,4040,,,,
7545,579,4877,4298,,,,
6169,3472,4091,619,,,,
6161,326,4517,4191,,,,
6164,2891,4960,2069,,,,
4519,2337,4924,2587,,,,
4510,957,4704,3747,,,,
4511,1131,4939,3808,,,,
4514,3002,4136,1134,,,,
9429,1864,4559,2695,,,,
9424,1175,4497,3322,,,,
5289,1999,4159,2160,,,,
5282,2028,4986,2958,,,,
7306,1928,4390,2462,,,,
7304,3559,4923,1364,,,,
7305,156,5000,4844,,,,
9283,674,4235,3561,,,,
7047,428,4785,4357,,,,
7042,2710,4191,1481,,,,
8601,1158,4832,3674,,,,
8605,276,4552,4276,,,,
2982,2913,4992,2079,,,,
2986,2520,4005,1485,,,,
1018,3456,4958,1502,,,,
1014,1378,4724,3346,,,,
1013,2972,4557,1585,,,,
437,3837,4639,802,,,,
430,2965,4715,1750,,,,
1050,701,4870,4169,,,,
7821,1700,4541,2841,,,,
7824,3004,4575,1571,,,,
1057,3821,4565,744,,,,
8986,3138,4212,1074,,,,
8983,1958,4673,2715,,,,
1832,1645,4186,2541,,,,
1833,284,4870,4586,,,,
1836,2116,4942,2826,,,,
3794,536,4954,4418,,,,
3797,82,4840,4758,,,,
3793,205,4942,4737,,,,
4980,3014,4007,993,,,,
4982,2467,4769,2302,,,,
4986,775,4378,3603,,,,
1950,2173,4602,2429,,,,
3249,2124,4895,2771,,,,
3241,220,4848,4628,,,,
3247,201,4189,3988,,,,
3245,1617,4644,3027,,,,
3307,968,4492,3524,,,,
5497,1063,4612,3549,,,,
5491,2929,4925,1996,,,,
3300,1554,4418,2864,,,,
2062,2299,4249,1950,,,,
2064,2570,4008,1438,,,,
515,1870,4851,2981,,,,
517,1930,4626,2696,,,,
1226,1710,4703,2993,,,,
621,627,4492,3865,,,,
1224,1830,4770,2940,,,,
626,506,4341,3835,,,,
1220,2966,4761,1795,,,,
4142,3335,4193,858,,,,
628,1037,4603,3566,,,,
1229,1749,4984,3235,,,,
8290,408,4819,4411,,,,
8295,995,4749,3754,,,,
8296,2305,4253,1948,,,,
3879,3810,4917,1107,,,,
3872,3176,4565,1389,,,,
8475,2979,4402,1423,,,,
8474,3407,4129,722,,,,
7564,1048,4710,3662,,,,
7565,1851,4450,2599,,,,
7560,3278,4108,830,,,,
9308,2358,4102,1744,,,,
4165,1526,4246,2720,,,,
4162,2492,4697,2205,,,,
4160,3258,4004,746,,,,
4169,3671,4066,395,,,,
2233,2014,4093,2079,,,,
5930,3029,4003,974,,,,
3498,1006,4722,3716,,,,
3499,3745,4260,515,,,,
2094,3998,4493,495,,,,
4574,1685,4943,3258,,,,
8423,2799,4024,1225,,,,
7364,240,4031,3791,,,,
7365,3162,4980,1818,,,,
3,390,4558,4168,,,,
9007,3789,4880,1091,,,,
9006,1320,4950,3630,,,,
9004,2606,4222,1616,,,,
9002,3014,4103,1089,,,,
7028,1423,4229,2806,,,,
7791,167,4005,3838,,,,
7795,555,4634,4079,,,,
7797,1250,4639,3389,,,,
7796,510,4884,4374,,,,
1035,792,4028,3236,,,,
4378,2126,4334,2208,,,,
4379,1078,4182,3104,,,,
4372,1047,4522,3475,,,,
4377,698,4384,3686,,,,
4374,1068,4900,3832,,,,
8661,459,4882,4423,,,,
8663,2777,4620,1843,,,,
4082,2703,4524,1821,,,,
5729,1984,4169,2185,,,,
8080,709,4674,3965,,,,
6648,2738,4333,1595,,,,
6644,3624,4089,465,,,,
7801,843,4220,3377,,,,
7800,1578,4996,3418,,,,
7805,891,4829,3938,,,,
6398,3703,4103,400,,,,
6393,318,4487,4169,,,,
6395,883,4408,3525,,,,
2396,3785,4193,408,,,,
2397,1500,4237,2737,,,,
2394,180,4482,4302,,,,
2393,1867,4535,2668,,,,
2399,122,4963,4841,,,,
1854,3349,4865,1516,,,,
2172,1470,4895,3425,,,,
2177,1588,4620,3032,,,,
3845,814,4780,3966,,,,
2178,394,4689,4295,,,,
1933,266,4548,4282,,,,
5129,3516,4895,1379,,,,
1934,1387,4282,2895,,,,
5121,332,4890,4558,,,,
7237,1105,4905,3800,,,,
7947,1228,4990,3762,,,,
9195,1319,4213,2894,,,,
6884,1278,4250,2972,,,,
6881,710,4118,3408,,,,
1203,226,4135,3909,,,,
8278,2227,4011,1784,,,,
8274,716,4882,4166,,,,
8412,2993,4486,1493,,,,
8416,1580,4330,2750,,,,
9806,2714,4769,2055,,,,
7582,2453,4778,2325,,,,
4148,682,4445,3763,,,,
4145,3453,4958,1505,,,,
4144,1209,4576,3367,,,,
4143,421,4729,4308,,,,
3857,1293,4692,3399,,,,
6485,1679,4148,2469,,,,
5911,3609,4931,1322,,,,
5912,3075,4532,1457,,,,
4552,3001,4694,1693,,,,
4550,3476,4654,1178,,,,
6072,3022,4264,1242,,,,
6071,3426,4149,723,,,,
6070,337,4930,4593,,,,
6078,1984,4592,2608,,,,
2619,1820,4920,3100,,,,
7345,1462,4860,3398,,,,
9029,1395,4371,2976,,,,
7001,3915,4279,364,,,,
749,2537,4252,1715,,,,
2949,1516,4257,2741,,,,
4314,3570,4397,827,,,,
4315,454,4420,3966,,,,
4316,1266,4410,3144,,,,
4319,593,4159,3566,,,,
3116,3844,4722,878,,,,
8647,923,4349,3426,,,,
8645,3295,4965,1670,,,,
5742,2136,4103,1967,,,,
5264,2306,4395,2089,,,,
2136,3794,4445,651,,,,
6662,3010,4834,1824,,,,
6665,1463,4517,3054,,,,
2370,503,4016,3513,,,,
1876,3639,4479,840,,,,
1871,924,4833,3909,,,,
4944,3721,4488,767,,,,
1606,1777,4339,2562,,,,
2111,2457,4017,1560,,,,
2114,2792,4220,1428,,,,
3289,3011,4945,1934,,,,
5103,285,4576,4291,,,,
883,309,4002,3693,,,,
882,1958,4224,2266,,,,
5245,3458,4148,690,,,,
7504,749,4965,4216,,,,
7350,1380,4793,3413,,,,
8250,373,4995,4622,,,,
669,1604,4496,2892,,,,
1264,3734,4630,896,,,,
8787,261,4869,4608,,,,
7618,1346,4436,3090,,,,
7619,1811,4197,2386,,,,
7615,3920,4509,589,,,,
7616,209,4093,3884,,,,
7610,1467,4164,2697,,,,
3282,1176,4598,3422,,,,
3281,3113,4566,1453,,,,
8433,3704,4215,511,,,,
9829,374,4587,4213,,,,
8040,1202,4699,3497,,,,
8517,665,4488,3823,,,,
4123,1285,4618,3333,,,,
4122,997,4707,3710,,,,
5684,2661,4095,1434,,,,
5682,252,4421,4169,,,,
5973,2174,4926,2752,,,,
5974,2215,4969,2754,,,,
2586,2027,4641,2614,,,,
2581,139,4722,4583,,,,
6059,7,4377,4370,,,,
6055,2660,4903,2243,,,,
6050,3771,4657,886,,,,
6053,3246,4237,991,,,,
2639,3372,4356,984,,,,
9598,2489,4586,2097,,,,
9594,201,4681,4480,,,,
9042,803,4749,3946,,,,
769,2627,4759,2132,,,,
763,1241,4647,3406,,,,
5379,1585,4122,2537,,,,
1076,479,4846,4367,,,,
1074,3916,4723,807,,,,
4338,1123,4115,2992,,,,
4335,2419,4043,1624,,,,
3135,3740,4725,985,,,,
3131,3067,4687,1620,,,,
5769,3807,4259,452,,,,
5766,3473,4340,867,,,,
5764,2692,4012,1320,,,,
6430,1162,4378,3216,,,,
7426,1322,4981,3659,,,,
7423,2263,4208,1945,,,,
7422,859,4173,3314,,,,
7421,675,4393,3718,,,,
7420,2309,4546,2237,,,,
7428,726,4492,3766,,,,
6605,3086,4939,1853,,,,
6607,3394,4107,713,,,,
5366,1896,4893,2997,,,,
2359,3947,4855,908,,,,
2353,1711,4894,3183,,,,
3739,958,4674,3716,,,,
3735,2362,4988,2626,,,,
3734,3239,4750,1511,,,,
4691,3834,4501,667,,,,
4922,1873,4887,3014,,,,
2132,390,4028,3638,,,,
4929,2506,4267,1761,,,,
2139,3648,4303,655,,,,
5168,779,4727,3948,,,,
9695,2317,4321,2004,,,,
1790,3716,4369,653,,,,
6840,3205,4612,1407,,,,
6847,2078,4079,2001,,,,
8233,764,4866,4102,,,,
6592,3111,4586,1475,,,,
7636,1041,4454,3413,,,,
9846,2710,4076,1366,,,,
3090,3536,4761,1225,,,,
647,667,4970,4303,,,,
648,1656,4847,3191,,,,
4106,3329,4981,1652,,,,
4109,2180,4376,2196,,,,
7613,3599,4765,1166,,,,
3892,1968,4187,2219,,,,
3893,2071,4302,2231,,,,
3890,2100,4450,2350,,,,
5955,2217,4371,2154,,,,
5957,3095,4785,1690,,,,
6031,3856,4807,951,,,,
6030,3417,4627,1210,,,,
9204,3338,4970,1632,,,,
7383,2890,4566,1676,,,,
7380,3475,4066,591,,,,
9061,1531,4005,2474,,,,
9060,3287,4057,770,,,,
3562,754,4820,4066,,,,
3560,314,4146,3832,,,,
4487,2221,4930,2709,,,,
4480,5,4812,4807,,,,
2900,1279,4091,2812,,,,
704,2957,4655,1698,,,,
706,2542,4230,1688,,,,
700,1075,4999,3924,,,,
5317,1124,4849,3725,,,,
5315,125,4445,4320,,,,
3154,2190,4573,2383,,,,
149,11,4843,4832,,,,
7409,582,4445,3863,,,,
7405,1934,4898,2964,,,,
7406,202,4114,3912,,,,
6628,1625,4069,2444,,,,
6623,3529,4556,1027,,,,
4715,45,4584,4539,,,,
4710,3907,4804,897,,,,
3715,1452,4246,2794,,,,
3714,2388,4142,1754,,,,
3711,6,4789,4783,,,,
4909,3160,4639,1479,,,,
4679,1977,4638,2661,,,,
4906,1661,4626,2965,,,,
5149,86,4975,4889,,,,
5142,932,4208,3276,,,,
125,1515,4772,3257,,,,
7220,586,4314,3728,,,,
7954,929,4609,3680,,,,
9168,3807,4624,817,,,,
3373,3489,4374,885,,,,
5420,3410,4053,643,,,,
7246,73,4817,4744,,,,
7240,1924,4631,2707,,,,
6828,2979,4008,1029,,,,
6829,449,4970,4521,,,,
8815,2257,4279,2022,,,,
8812,1686,4333,2647,,,,
8818,2818,4101,1283,,,,
8748,1932,4535,2603,,,,
8215,1224,4892,3668,,,,
8742,1382,4630,3248,,,,
8217,706,4868,4162,,,,
7655,1993,4578,2585,,,,
7657,2367,4925,2558,,,,
8176,1859,4748,2889,,,,
8179,2675,4551,1876,,,,
9868,2178,4455,2277,,,,
9861,866,4303,3437,,,,
9865,1762,4323,2561,,,,
1518,2493,4054,1561,,,,
1517,482,4511,4029,,,,
1511,832,4658,3826,,,,
1510,2886,4728,1842,,,,
1512,180,4870,4690,,,,
6968,1474,4354,2880,,,,
261,1712,4364,2652,,,,
267,3839,4698,859,,,,
6015,1138,4138,3000,,,,
9262,553,4897,4344,,,,
9265,3355,4071,716,,,,
9089,3990,4904,914,,,,
5088,2093,4826,2733,,,,
5083,1802,4402,2600,,,,
3505,2705,4970,2265,,,,
2673,658,4004,3346,,,,
2676,3059,4209,1150,,,,
2678,3363,4838,1475,,,,
2920,653,4093,3440,,,,
2926,1974,4577,2603,,,,
5338,1887,4838,2951,,,,
3173,1111,4385,3274,,,,
1163,3535,4238,703,,,,
473,1114,4774,3660,,,,
8550,3234,4876,1642,,,,
8559,909,4112,3203,,,,
8000,3459,4045,586,,,,
7463,3236,4456,1220,,,,
7460,2775,4458,1683,,,,
4934,1842,4910,3068,,,,
4732,2089,4277,2188,,,,
5854,184,4762,4578,,,,
5853,1862,4442,2580,,,,
3775,1426,4430,3004,,,,
4654,2388,4146,1758,,,,
4650,3255,4471,1216,,,,
7880,865,4790,3925,,,,
7884,972,4346,3374,,,,
109,646,4247,3601,,,,
100,3547,4394,847,,,,
101,795,4777,3982,,,,
106,479,4665,4186,,,,
105,1544,4997,3453,,,,
7264,2626,4099,1473,,,,
6205,98,4821,4723,,,,
6201,2557,4554,1997,,,,
6209,1181,4844,3663,,,,
6809,1952,4096,2144,,,,
6803,94,5000,4906,,,,
6800,2419,4397,1978,,,,
9743,3690,4204,514,,,,
8834,1439,4035,2596,,,,
8833,618,4891,4273,,,,
7677,1242,4151,2909,,,,
7675,2130,4448,2318,,,,
1757,226,4035,3809,,,,
1754,1722,4457,2735,,,,
1287,3958,4787,829,,,,
1281,71,4965,4894,,,,
1288,2504,4578,2074,,,,
8760,3123,4652,1529,,,,
8056,1593,4496,2903,,,,
5629,1947,4408,2461,,,,
5622,3798,4607,809,,,,
5620,1641,4415,2774,,,,
8493,485,4071,3586,,,,
8494,3233,4281,1048,,,,
8498,983,4930,3947,,,,
5995,29,4860,4831,,,,
5997,421,4932,4511,,,,
5992,1625,4085,2460,,,,
4677,2048,4577,2529,,,,
6783,2996,4391,1395,,,,
6786,3078,4438,1360,,,,
6788,3099,4993,1894,,,,
247,3717,4841,1124,,,,
9241,1679,4113,2434,,,,
9536,3068,4811,1743,,,,
9242,1389,4519,3130,,,,
9245,1564,4897,3333,,,,
3698,1777,4554,2777,,,,
3526,154,4366,4212,,,,
2695,3766,4908,1142,,,,
2693,3204,4379,1175,,,,
2691,3477,4239,762,,,,
2690,194,4136,3942,,,,
4535,2046,4569,2523,,,,
6402,1140,4608,3468,,,,
8533,1777,4196,2419,,,,
4283,622,4878,4256,,,,
4286,2581,4250,1669,,,,
4284,2451,4802,2351,,,,
387,1880,4916,3036,,,,
4750,2992,4432,1440,,,,
4751,1583,4413,2830,,,,
5872,1525,4915,3390,,,,
5876,1187,4923,3736,,,,
5874,3983,4949,966,,,,
5878,2048,4460,2412,,,,
3752,3338,4192,854,,,,
3754,1035,4757,3722,,,,
4633,1458,4494,3036,,,,
2192,3630,4635,1005,,,,
2198,2013,4075,2062,,,,
4639,668,4117,3449,,,,
168,2637,4513,1876,,,,
164,190,4895,4705,,,,
165,2570,4223,1653,,,,
2040,957,4417,3460,,,,
2739,2270,4325,2055,,,,
9180,3575,4849,1274,,,,
9181,1052,4036,2984,,,,
9188,51,4477,4426,,,,
7206,3880,4157,277,,,,
7205,1181,4175,2994,,,,
6225,3201,4134,933,,,,
8859,2313,4379,2066,,,,
8858,661,4622,3961,,,,
8852,2299,4420,2121,,,,
801,2503,4401,1898,,,,
8856,2727,4970,2243,,,,
8855,2454,4710,2256,,,,
5274,1446,4132,2686,,,,
5276,3594,4778,1184,,,,
1776,3735,4062,327,,,,
5271,405,4276,3871,,,,
1773,1678,4886,3208,,,,
1779,3524,4058,534,,,,
1551,1422,4246,2824,,,,
1555,3957,4756,799,,,,
3039,3177,4228,1051,,,,
1557,3816,4814,998,,,,
3036,1924,4946,3022,,,,
3033,1498,4549,3051,,,,
8703,191,4493,4302,,,,
8701,1116,4495,3379,,,,
8709,3199,4210,1011,,,,
9327,1537,4624,3087,,,,
6422,784,4563,3779,,,,
6428,1610,4857,3247,,,,
6429,50,4234,4184,,,,
6761,907,4288,3381,,,,
9979,3871,4416,545,,,,
229,3613,4778,1165,,,,
2504,970,4779,3809,,,,
5045,1257,4253,2996,,,,
9515,3901,4600,699,,,,
1252,1206,4909,3703,,,,
3205,694,4362,3668,,,,
1627,641,4574,3933,,,,
1626,1008,4112,3104,,,,
1624,1039,4131,3092,,,,
1124,2562,4356,1794,,,,
1127,909,4068,3159,,,,
8516,2020,4759,2739,,,,
5819,504,4221,3717,,,,
4611,218,4273,4055,,,,
4610,432,4116,3684,,,,
4616,1450,4316,2866,,,,
146,3840,4104,264,,,,
142,1849,4357,2508,,,,
143,215,4648,4433,,,,
148,1685,4090,2405,,,,
2712,1653,4872,3219,,,,
2716,572,4110,3538,,,,
9179,576,4910,4334,,,,
5454,3267,4172,905,,,,
7225,3187,4594,1407,,,,
9164,1647,4420,2773,,,,
9166,1084,4202,3118,,,,
9160,2267,4982,2715,,,,
9163,603,4786,4183,,,,
6249,1155,4308,3153,,,,
6241,3161,4069,908,,,,
6247,2893,4058,1165,,,,
9703,1545,4311,2766,,,,
9704,3177,4798,1621,,,,
8872,2535,4778,2243,,,,
8877,151,4149,3998,,,,
827,1116,4280,3164,,,,
8167,395,4726,4331,,,,
1711,1223,4871,3648,,,,
5256,1387,4360,2973,,,,
5258,1518,4761,3243,,,,
8725,1007,4110,3103,,,,
4180,1520,4491,2971,,,,
5662,249,4927,4678,,,,
5661,1997,4734,2737,,,,
5660,891,4543,3652,,,,
6406,3290,4351,1061,,,,
8180,2118,4856,2738,,,,
7765,1191,4654,3463,,,,
7760,1274,4528,3254,,,,
7761,1964,4586,2622,,,,
7763,2176,4719,2543,,,,
3905,3208,4388,1180,,,,
3906,2321,4718,2397,,,,
3907,429,4595,4166,,,,
3900,3505,4780,1275,,,,
3903,1919,4166,2247,,,,
3908,3317,4626,1309,,,,
6745,1706,4340,2634,,,,
202,966,4276,3310,,,,
207,1558,4141,2583,,,,
206,2624,4788,2164,,,,
209,1415,4788,3373,,,,
3657,1706,4051,2345,,,,
3650,2927,4137,1210,,,,
2525,3209,4777,1568,,,,
2528,1343,4819,3476,,,,
5064,1389,4242,2853,,,,
5066,3265,4498,1233,,,,
5069,2285,4742,2457,,,,
929,3280,4765,1485,,,,
9576,1594,4400,2806,,,,
9575,888,4706,3818,,,,
927,623,4975,4352,,,,
5390,2591,4937,2346,,,,
5394,2785,4193,1408,,,,
785,300,4445,4145,,,,
9395,2090,4753,2663,,,,
9392,1615,4123,2508,,,,
7157,3345,4743,1398,,,,
7154,1633,4494,2861,,,,
402,1589,4452,2863,,,,
786,1238,4673,3435,,,,
7483,609,4088,3479,,,,
2899,2519,4490,1971,,,,
2897,1864,4213,2349,,,,
2891,2046,4139,2093,,,,
2893,3855,4337,482,,,,
1106,1993,4382,2389,,,,
1456,1254,4040,2786,,,,
1837,2694,4443,1749,,,,
1891,2012,4406,2394,,,,
4798,355,4112,3757,,,,
4794,2023,4690,2667,,,,
4927,1494,4968,3474,,,,
4797,3742,4950,1208,,,,
4793,2026,4971,2945,,,,
5830,3072,4003,931,,,,
6903,1568,4967,3399,,,,
6497,2800,4575,1775,,,,
2778,1953,4008,2055,,,,
2775,2788,4835,2047,,,,
9492,3289,4991,1702,,,,
9144,3470,4531,1061,,,,
9145,2953,4880,1927,,,,
6269,219,4901,4682,,,,
3467,718,4400,3682,,,,
8899,3553,4534,981,,,,
8897,2715,4725,2010,,,,
3075,424,4426,4002,,,,
5648,2048,4710,2662,,,,
5641,1719,4688,2969,,,,
5642,3624,4658,1034,,,,
487,1038,4213,3175,,,,
7742,260,4482,4222,,,,
7740,2077,4063,1986,,,,
7746,1493,4713,3220,,,,
3921,1097,4030,2933,,,,
3926,3868,4018,150,,,,
3925,3980,4773,793,,,,
8306,2733,4299,1566,,,,
6721,1364,4345,2981,,,,
8303,3376,4703,1327,,,,
9939,3444,4858,1414,,,,
9930,2800,4872,2072,,,,
6093,116,4610,4494,,,,
3671,3934,4590,656,,,,
3677,1932,4590,2658,,,,
2543,1142,4920,3778,,,,
2540,3638,4205,567,,,,
2547,3241,4655,1414,,,,
2544,342,4180,3838,,,,
2548,2828,4570,1742,,,,
1103,1791,4391,2600,,,,
5000,641,4752,4111,,,,
5004,760,4792,4032,,,,
3588,1249,4966,3717,,,,
903,937,4610,3673,,,,
4428,196,4969,4773,,,,
901,344,4153,3809,,,,
904,3347,4189,842,,,,
4420,111,4916,4805,,,,
909,2172,4623,2451,,,,
4426,2613,4341,1728,,,,
4424,339,4475,4136,,,,
4425,1794,4023,2229,,,,
9559,727,4791,4064,,,,
9557,84,4196,4112,,,,
8935,991,4327,3336,,,,
8931,3501,4682,1181,,,,
8933,2354,4514,2160,,,,
7174,1465,4083,2618,,,,
7176,58,4505,4447,,,,
1694,3336,4199,863,,,,
1695,1864,4288,2424,,,,
1691,1018,4086,3068,,,,
1470,3519,4437,918,,,,
4229,327,4526,4199,,,,
4225,3607,4987,1380,,,,
4221,1097,4437,3340,,,,
4223,555,4554,3999,,,,
5300,3249,4094,845,,,,
2289,85,4904,4819,,,,
2282,1849,4222,2373,,,,
4827,2989,4978,1989,,,,
9127,428,4149,3721,,,,
8313,3903,4521,618,,,,
7915,46,4502,4456,,,,
6289,3057,4106,1049,,,,
6282,155,4871,4716,,,,
180,510,4393,3883,,,,
863,500,4162,3662,,,,
864,1971,4309,2338,,,,
3442,2312,4968,2656,,,,
2026,2905,4545,1640,,,,
2752,107,4944,4837,,,,
2753,3093,4519,1426,,,,
2028,51,4954,4903,,,,
2759,3900,4640,740,,,,
5210,1324,4561,3237,,,,
5218,1725,4053,2328,,,,
5219,2477,4142,1665,,,,
3057,2856,4573,1717,,,,
4597,3935,4254,319,,,,
1313,1089,4897,3808,,,,
1318,2376,4831,2455,,,,
6447,3252,4941,1689,,,,
6916,1230,4034,2804,,,,
6442,1972,4472,2500,,,,
6443,1129,4068,2939,,,,
6912,2393,4911,2518,,,,
6441,1023,4783,3760,,,,
6919,3851,4083,232,,,,
7720,1576,4648,3072,,,,
7723,699,4397,3698,,,,
7727,2239,4228,1989,,,,
3943,2992,4646,1654,,,,
8324,1363,4292,2929,,,,
8321,3152,4091,939,,,,
8322,1218,4038,2820,,,,
9912,1889,4841,2952,,,,
4055,1154,4867,3713,,,,
4054,2583,4490,1907,,,,
4051,1658,4046,2388,,,,
3613,3665,4523,858,,,,
3614,1520,4832,3312,,,,
2569,776,4786,4010,,,,
2568,377,4222,3845,,,,
2560,3205,4550,1345,,,,
2562,379,4089,3710,,,,
5023,246,4900,4654,,,,
4444,887,4250,3363,,,,
4446,1874,4173,2299,,,,
641,29,4263,4234,,,,
1532,2266,4853,2587,,,,
5198,778,4297,3519,,,,
1616,321,4719,4398,,,,
8911,3598,4164,566,,,,
8917,702,4375,3673,,,,
7112,368,4758,4390,,,,
7115,1569,4736,3167,,,,
7119,2919,4114,1195,,,,
1611,1419,4244,2825,,,,
1678,3695,4062,367,,,,
1674,2941,4320,1379,,,,
1670,1872,4963,3091,,,,
1673,1574,4005,2431,,,,
1410,1245,4907,3662,,,,
1415,1840,4362,2522,,,,
4209,3423,4740,1317,,,,
4202,2457,4586,2129,,,,
4203,2830,4235,1405,,,,
5567,2677,4745,2068,,,,
305,1763,4528,2765,,,,
7296,1769,4708,2939,,,,
6117,2390,4971,2581,,,,
6111,3393,4210,817,,,,
7932,3781,4441,660,,,,
9100,0,4598,4598,,,,
9142,3150,4304,1154,,,,
7970,1696,4938,3242,,,,
9496,1785,4444,2659,,,,
3421,3174,4686,1512,,,,
4858,2234,4460,2226,,,,
4856,3702,4343,641,,,,
6965,2515,4531,2016,,,,
6964,1083,4192,3109,,,,
1084,2127,4040,1913,,,,
1082,470,4976,4506,,,,
1089,2243,4180,1937,,,,
449,1704,4639,2935,,,,
1339,1158,4008,2850,,,,
446,2712,4945,2233,,,,
1332,908,4080,3172,,,,
6933,509,4701,4192,,,,
6936,3984,4593,609,,,,
8120,267,4427,4160,,,,
7706,1017,4592,3575,,,,
38,712,4745,4033,,,,
7702,3083,4037,954,,,,
7703,3059,4331,1272,,,,
31,1082,4027,2945,,,,
30,1012,4946,3934,,,,
8347,2592,4285,1693,,,,
1901,260,4660,4400,,,,
3464,1461,4633,3172,,,,
4079,1346,4474,3128,,,,
3461,373,4792,4419,,,,
5790,1127,4051,2924,,,,
4469,258,4554,4296,,,,
4463,1702,4028,2326,,,,
942,942,4727,3785,,,,
941,2574,4996,2422,,,,
9663,3904,4890,986,,,,
7138,3600,4135,535,,,,
7130,2103,4457,2354,,,,
7944,1150,4149,2999,,,,
1656,2614,4927,2313,,,,
586,1838,4566,2728,,,,
587,3692,4443,751,,,,
585,706,4965,4259,,,,
582,3880,4691,811,,,,
588,2095,4820,2725,,,,
2834,212,4150,3938,,,,
5406,1629,4074,2445,,,,
5404,728,4838,4110,,,,
5403,620,4117,3497,,,,
1433,3642,4741,1099,,,,
3399,2039,4358,2319,,,,
1381,1620,4160,2540,,,,
7688,1991,4402,2411,,,,
4260,597,4838,4241,,,,
4263,3009,4445,1436,,,,
4266,1917,4661,2744,,,,
3702,86,4324,4238,,,,
1737,366,4172,3806,,,,
5546,3769,4458,689,,,,
5547,3636,4047,411,,,,
5544,2559,4809,2250,,,,
5545,3940,4700,760,,,,
1881,3657,4470,813,,,,
8599,52,4369,4317,,,,
5893,3580,4708,1128,,,,
4662,2030,4443,2413,,,,
9897,3224,4785,1561,,,,
327,3740,4703,963,,,,
328,3864,4289,425,,,,
329,1551,4140,2589,,,,
6139,3716,4128,412,,,,
6133,2215,4623,2408,,,,
6136,1933,4203,2270,,,,
9470,79,4947,4868,,,,
2249,2863,4943,2080,,,,
2245,3356,4292,936,,,,
2247,3893,4402,509,,,,
3400,775,4749,3974,,,,
3402,3546,4026,480,,,,
4878,3718,4893,1175,,,,
2069,492,4315,3823,,,,
2799,1771,4569,2798,,,,
2790,2245,4319,2074,,,,
2066,1935,4082,2147,,,,
9787,2180,4855,2675,,,,
7093,1239,4374,3135,,,,
8105,842,4317,3475,,,,
8101,1986,4805,2819,,,,
8102,2252,4333,2081,,,,
460,579,4200,3621,,,,
1355,3205,4078,873,,,,
8361,3302,4820,1518,,,,
8363,3605,4186,581,,,,
8362,895,4514,3619,,,,
8364,2630,4621,1991,,,,
8366,3576,4051,475,,,,
3180,2293,4493,2200,,,,
4019,519,4174,3655,,,,
4018,1511,4878,3367,,,,
4011,174,4839,4665,,,,
3988,3054,4273,1219,,,,
3987,2054,4958,2904,,,,
3980,1896,4204,2308,,,,
288,1498,4708,3210,,,,
280,599,4586,3987,,,,
283,1805,4019,2214,,,,
286,2317,4116,1799,,,,
2474,1420,4946,3526,,,,
2470,1236,4606,3370,,,,
7871,3346,4133,787,,,,
6309,2473,4939,2466,,,,
6308,1470,4132,2662,,,,
6304,2515,4973,2458,,,,
6307,485,4608,4123,,,,
6302,3508,4857,1349,,,,
9319,2349,4627,2278,,,,
9641,3858,4695,837,,,,
8956,3147,4527,1380,,,,
1630,1611,4231,2620,,,,
3215,2962,4336,1374,,,,
1636,804,4157,3353,,,,
1989,1236,4421,3185,,,,
2814,2746,4765,2019,,,,
2812,1946,4490,2544,,,,
565,3838,4851,1013,,,,
5429,473,4569,4096,,,,
5424,3709,4904,1195,,,,
5421,3754,4224,470,,,,
5423,3894,4164,270,,,,
1181,529,4463,3934,,,,
4241,159,4594,4435,,,,
5524,79,4414,4335,,,,
5528,346,4796,4450,,,,
42,3995,4790,795,,,,
6544,2174,4256,2082,,,,
7515,2972,4624,1652,,,,
6151,482,4190,3708,,,,
6152,2999,4933,1934,,,,
6153,444,4843,4399,,,,
6154,1696,4277,2581,,,,
6725,1275,4297,3022,,,,
6587,3048,4195,1147,,,,
8755,2173,4199,2026,,,,
2262,1240,4521,3281,,,,
2261,2728,4236,1508,,,,
4811,2352,4319,1967,,,,
2045,3222,4744,1522,,,,
4815,3842,4495,653,,,,
4814,734,4043,3309,,,,
9412,1720,4923,3203,,,,
9417,1776,4001,2225,,,,
9616,1179,4523,3344,,,,
7629,306,4155,3849,,,,
7078,2013,4915,2902,,,,
7074,3577,4731,1154,,,,
7070,2030,4976,2946,,,,
8162,1174,4149,2975,,,,
8171,2691,4418,1727,,,,
4387,2636,4672,2036,,,,
405,283,4150,3867,,,,
1374,1375,4424,3049,,,,
4031,3835,4710,875,,,,
4035,1802,4953,3151,,,,
2455,791,4496,3705,,,,
2451,2621,4539,1918,,,,
2453,1946,4411,2465,,,,
7852,1944,4315,2371,,,,
7851,1038,4240,3202,,,,
7857,2268,4639,2371,,,,
6367,949,4577,3628,,,,
653,1306,4184,2878,,,,
1505,613,4689,4076,,,,
9338,1802,4348,2546,,,,
9629,1461,4902,3441,,,,
3220,529,4753,4224,,,,
3233,3915,4148,233,,,,
1965,584,4805,4221,,,,
7357,1593,4684,3091,,,,
5442,2810,4204,1394,,,,
5440,1055,4953,3898,,,,
5445,720,4423,3703,,,,
5508,1471,4331,2860,,,,
5505,1832,4629,2797,,,,
5502,811,4442,3631,,,,
542,2789,4875,2086,,,,
6560,1795,4435,2640,,,,
7686,703,4278,3575,,,,
7683,1418,4443,3025,,,,
3325,1633,4522,2889,,,,
3827,727,4699,3972,,,,
3824,1721,4432,2711,,,,
3820,237,4444,4207,,,,
3828,1364,4173,2809,,,,
8445,2578,4169,1591,,,,
7538,915,4098,3183,,,,
6176,3134,4378,1244,,,,
6171,602,4812,4210,,,,
9480,2996,4444,1448,,,,
2206,1248,4239,2991,,,,
2207,3568,4376,808,,,,
4836,590,4907,4317,,,,
5296,1880,4811,2931,,,,
5290,1507,4844,3337,,,,
5291,1305,4260,2955,,,,
6994,560,4290,3730,,,,
8143,778,4772,3994,,,,
6991,2557,4686,2129,,,,
7050,3407,4440,1033,,,,
7051,3689,4698,1009,,,,
7056,3846,4043,197,,,,
8149,378,4158,3780,,,,
6998,2339,4704,2365,,,,
6995,1111,4563,3452,,,,
6996,2439,4494,2055,,,,
50,2460,4471,2011,,,,
9992,355,4137,3782,,,,
9995,2788,4273,1485,,,,
2334,3854,4489,635,,,,
6690,3657,4388,731,,,,
2436,556,4593,4037,,,,
2434,3864,4932,1068,,,,
7839,521,4811,4290,,,,
7837,3815,4962,1147,,,,
6342,1892,4941,3049,,,,
9604,2945,4564,1619,,,,
9608,1543,4828,3285,,,,
1801,3832,4228,396,,,,
8990,2725,4548,1823,,,,
8994,2654,4076,1422,,,,
3259,3308,4346,1038,,,,
1942,2321,4933,2612,,,,
3252,1309,4505,3196,,,,
2859,1515,4060,2545,,,,
1492,2492,4080,1588,,,,
5462,2226,4515,2289,,,,
5467,3993,4098,105,,,,
5468,401,4169,3768,,,,
525,1473,4317,2844,,,,
527,2394,4967,2573,,,,
520,1033,4984,3951,,,,
523,1792,4228,2436,,,,
1231,3742,4672,930,,,,
1239,3019,4012,993,,,,
8285,491,4017,3526,,,,
6503,417,4259,3842,,,,
6500,2328,4172,1844,,,,
4676,2849,4806,1957,,,,
2485,3387,4144,757,,,,
3806,3317,4940,1623,,,,
3801,1534,4356,2822,,,,
8463,13,4090,4077,,,,
8466,2424,4031,1607,,,,
7558,3875,4008,133,,,,
7550,3563,4263,700,,,,
4174,2726,4051,1325,,,,
7395,1441,4377,2936,,,,
997,1497,4606,3109,,,,
7393,3926,4612,686,,,,
2226,199,4000,3801,,,,
5924,3619,4100,481,,,,
5925,3363,4931,1568,,,,
5920,424,4958,4534,,,,
5923,108,4234,4126,,,,
4507,2723,4082,1359,,,,
4506,2060,4852,2792,,,,
4501,600,4263,3663,,,,
4503,3895,4886,991,,,,
2083,801,4899,4098,,,,
7314,770,4914,4144,,,,
9013,1601,4528,2927,,,,
7038,1211,4991,3780,,,,
7788,124,4562,4438,,,,
7782,3110,4521,1411,,,,
7783,413,4947,4534,,,,
1003,2228,4952,2724,,,,
8616,962,4957,3995,,,,
8611,2854,4913,2059,,,,
8612,907,4444,3537,,,,
8618,3757,4790,1033,,,,
5717,1680,4747,3067,,,,
7813,1332,4391,3059,,,,
7819,2207,4597,2390,,,,
4495,1100,4802,3702,,,,
9375,880,4705,3825,,,,
2410,3620,4358,738,,,,
2142,188,4599,4411,,,,
2416,3038,4140,1102,,,,
2419,3484,4791,1307,,,,
1922,1348,4845,3497,,,,
1923,88,4024,3936,,,,
3317,2411,4372,1961,,,,
22,1140,4375,3235,,,,
61,556,4258,3702,,,,
64,1787,4349,2562,,,,
69,270,4272,4002,,,,
351,3432,4888,1456,,,,
506,1173,4940,3767,,,,
500,1837,4932,3095,,,,
1217,1411,4570,3159,,,,
636,1019,4906,3887,,,,
6523,1324,4186,2862,,,,
8269,762,4634,3872,,,,
6527,2478,4244,1766,,,,
8260,1705,4900,3195,,,,
3861,1976,4986,3010,,,,
8400,3856,4464,608,,,,
8407,2906,4272,1366,,,,
7570,3900,4082,182,,,,
7575,1288,4735,3447,,,,
7577,2689,4472,1783,,,,
9811,1945,4261,2316,,,,
9812,307,4506,4199,,,,
4155,3380,4280,900,,,,
5904,91,4915,4824,,,,
4561,3965,4995,1030,,,,
4566,1868,4192,2324,,,,
9601,2511,4123,1612,,,,
9602,3770,4679,909,,,,
9606,3246,4445,1199,,,,
2604,3638,4762,1124,,,,
9033,2984,4752,1768,,,,
7017,3772,4028,256,,,,
7012,1560,4150,2590,,,,
7011,643,4607,3964,,,,
732,2119,4524,2405,,,,
753,351,4113,3762,,,,
1027,207,4942,4735,,,,
5348,2038,4197,2159,,,,
1028,1897,4565,2668,,,,
3788,3275,4808,1533,,,,
4361,1482,4443,2961,,,,
8995,306,4112,3806,,,,
3109,3618,4817,1199,,,,
3104,3301,4367,1066,,,,
8671,3917,4009,92,,,,
4093,908,4021,3113,,,,
4092,839,4891,4052,,,,
4098,3087,4057,970,,,,
5734,1372,4568,3196,,,,
5731,1215,4046,2831,,,,
5732,3950,4280,330,,,,
8093,117,4091,3974,,,,
8090,479,4772,4293,,,,
6382,739,4747,4008,,,,
2385,552,4666,4114,,,,
1849,2925,4759,1834,,,,
4958,110,4499,4389,,,,
2168,1776,4897,3121,,,,
4950,3815,4245,430,,,,
4951,145,4425,4280,,,,
4955,3736,4235,499,,,,
2129,3438,4808,1370,,,,
5138,1004,4052,3048,,,,
6890,3708,4387,679,,,,
6892,413,4070,3657,,,,
6899,3549,4349,800,,,,
612,1394,4326,2932,,,,
613,927,4117,3190,,,,
617,1901,4543,2642,,,,
614,3798,4072,274,,,,
5461,3916,4173,257,,,,
5463,3327,4779,1452,,,,
1494,1855,4902,3047,,,,
5464,2120,4154,2034,,,,
8426,3183,4797,1614,,,,
5469,210,4978,4768,,,,
4134,1562,4349,2787,,,,
4135,1345,4658,3313,,,,
5692,3752,4784,1032,,,,
3844,437,4280,3843,,,,
3846,3267,4322,1055,,,,
3849,2690,4629,1939,,,,
5963,415,4230,3815,,,,
4541,1323,4088,2765,,,,
2594,2059,4930,2871,,,,
2591,2623,4925,2302,,,,
2599,3863,4982,1119,,,,
8603,799,4136,3337,,,,
6049,3633,4561,928,,,,
2621,962,4414,3452,,,,
2628,3034,4194,1160,,,,
2629,2659,4468,1809,,,,
9583,3247,4574,1327,,,,
7353,674,4633,3959,,,,
9584,3111,4438,1327,,,,
9589,2276,4419,2143,,,,
9230,2177,4950,2773,,,,
9051,2371,4752,2381,,,,
9055,1764,4922,3158,,,,
776,160,4471,4311,,,,
773,2224,4888,2664,,,,
779,937,4821,3884,,,,
778,2967,4711,1744,,,,
2979,3217,4035,818,,,,
2971,3101,4233,1132,,,,
2977,3826,4244,418,,,,
1048,914,4241,3327,,,,
3128,1453,4023,2570,,,,
3129,1003,4186,3183,,,,
3124,3427,4264,837,,,,
8650,2649,4405,1756,,,,
8654,1808,4571,2763,,,,
5751,3055,4289,1234,,,,
2020,3569,4673,1104,,,,
2021,308,4761,4453,,,,
6675,562,4951,4389,,,,
6677,439,4092,3653,,,,
6671,1901,4536,2635,,,,
6670,3803,4555,752,,,,
6673,1927,4291,2364,,,,
2326,3153,4147,994,,,,
5197,1514,4848,3334,,,,
2367,3722,4929,1207,,,,
1712,3891,4141,250,,,,
2362,2280,4360,2080,,,,
2361,749,4734,3985,,,,
3728,2003,4406,2403,,,,
1869,3691,4204,513,,,,
3726,2686,4440,1754,,,,
3722,490,4844,4354,,,,
4930,504,4692,4188,,,,
4931,3874,4749,875,,,,
4932,228,4045,3817,,,,
4935,1099,4082,2983,,,,
4680,162,4905,4743,,,,
4938,3594,4229,635,,,,
2109,1950,4091,2141,,,,
5118,650,4959,4309,,,,
9,626,4379,3753,,,,
895,699,4774,4075,,,,
1788,437,4784,4347,,,,
1789,3857,4538,681,,,,
1781,3496,4286,790,,,,
1784,545,4741,4196,,,,
6877,2393,4582,2189,,,,
6871,1111,4014,2903,,,,
8220,1584,4864,3280,,,,
8225,1285,4716,3431,,,,
8229,16,4715,4699,,,,
676,56,4444,4388,,,,
672,216,4669,4453,,,,
7609,829,4920,4091,,,,
7605,3140,4340,1200,,,,
7604,2556,4081,1525,,,,
7601,1347,4692,3345,,,,
4647,3025,4459,1434,,,,
9855,1205,4364,3159,,,,
1257,1315,4629,3314,,,,
1520,1887,4300,2413,,,,
1521,1160,4783,3623,,,,
1528,3073,4481,1408,,,,
1259,540,4408,3868,,,,
4113,2703,4963,2260,,,,
4110,574,4807,4233,,,,
5947,1404,4239,2835,,,,
5942,532,4094,3562,,,,
5943,2674,4787,2113,,,,
5940,557,4398,3841,,,,
6029,2770,4040,1270,,,,
2641,3455,4772,1317,,,,
2643,3724,4928,1204,,,,
2644,1620,4470,2850,,,,
9218,3197,4327,1130,,,,
9211,3158,4284,1126,,,,
9216,816,4946,4130,,,,
9073,2033,4082,2049,,,,
2915,231,4782,4551,,,,
2917,3624,4508,884,,,,
715,2477,4499,2022,,,,
712,35,4696,4661,,,,
1061,1899,4352,2453,,,,
5301,1018,4111,3093,,,,
5303,977,4575,3598,,,,
5307,490,4602,4112,,,,
4322,3582,4216,634,,,,
4327,3943,4760,817,,,,
3144,3000,4917,1917,,,,
5779,1150,4561,3411,,,,
5771,2999,4571,1572,,,,
5777,2457,4478,2021,,,,
5776,1611,4286,2675,,,,
7411,419,4447,4028,,,,
6619,970,4043,3073,,,,
2341,3058,4360,1302,,,,
2340,1358,4634,3276,,,,
1888,3108,4262,1154,,,,
3707,705,4295,3590,,,,
3704,1672,4197,2525,,,,
3705,3534,4805,1271,,,,
2121,1672,4548,2876,,,,
4916,3969,4563,594,,,,
4912,1537,4374,2837,,,,
4910,434,4666,4232,,,,
5172,609,4386,3777,,,,
5175,1765,4887,3122,,,,
137,445,4816,4371,,,,
1,1119,4070,2951,,,,
9683,3863,4281,418,,,,
6854,533,4067,3534,,,,
6851,1531,4318,2787,,,,
6852,3374,4055,681,,,,
83,1120,4147,3027,,,,
81,709,4013,3304,,,,
85,3414,4252,838,,,,
8804,645,4037,3392,,,,
8808,3867,4213,346,,,,
8809,1390,4854,3464,,,,
6585,3876,4066,190,,,,
7626,777,4434,3657,,,,
7620,3695,4785,1090,,,,
9879,129,4301,4172,,,,
9877,1295,4618,3323,,,,
9874,383,4378,3995,,,,
1503,613,4212,3599,,,,
655,417,4860,4443,,,,
1509,1415,4250,2835,,,,
3080,3980,4068,88,,,,
3880,3636,4989,1353,,,,
3883,288,4722,4434,,,,
3882,1790,4882,3092,,,,
6704,377,4596,4219,,,,
6706,3441,4468,1027,,,,
6004,1266,4125,2859,,,,
9270,1458,4985,3527,,,,
9278,2000,4614,2614,,,,
6992,2087,4062,1975,,,,
9097,2214,4718,2504,,,,
3579,3036,4460,1424,,,,
3574,3220,4873,1653,,,,
5096,3460,4406,946,,,,
2664,129,4950,4821,,,,
2661,3633,4773,1140,,,,
5324,536,4677,4141,,,,
5329,1154,4937,3783,,,,
730,194,4928,4734,,,,
735,411,4834,4423,,,,
738,1437,4508,3071,,,,
4987,1886,4492,2606,,,,
8566,3739,4453,714,,,,
8565,3433,4384,951,,,,
7479,1387,4439,3052,,,,
7470,2841,4241,1400,,,,
6638,2265,4695,2430,,,,
7022,1142,4907,3765,,,,
4707,15,4112,4097,,,,
4701,1795,4936,3141,,,,
3767,3791,4845,1054,,,,
3768,474,4269,3795,,,,
3769,3670,4102,432,,,,
2494,677,4864,4187,,,,
2496,3891,4089,198,,,,
7897,988,4381,3393,,,,
7894,62,4750,4688,,,,
5153,342,4667,4325,,,,
5152,2429,4372,1943,,,,
5155,747,4383,3636,,,,
5157,3916,4278,362,,,,
115,3683,4486,803,,,,
114,3174,4984,1810,,,,
117,843,4286,3443,,,,
119,3876,4171,295,,,,
7279,1161,4324,3163,,,,
6836,2653,4678,2025,,,,
6834,2350,4577,2227,,,,
8822,1002,4426,3424,,,,
8823,770,4522,3752,,,,
8820,3338,4011,673,,,,
8821,361,4724,4363,,,,
8827,721,4967,4246,,,,
8824,43,4453,4410,,,,
8770,1130,4445,3315,,,,
7642,3110,4629,1519,,,,
1749,653,4072,3419,,,,
1487,1131,4046,2915,,,,
1742,2799,4719,1920,,,,
9012,2334,4524,2190,,,,
7292,36,4452,4416,,,,
9130,1755,4907,3152,,,,
1290,3334,4935,1601,,,,
1566,1443,4756,3313,,,,
5636,1641,4158,2517,,,,
8480,1323,4100,2777,,,,